10,0,18,0,18,0,0,0,5,end
None,None,1,hole,1,None,None,None,8,None
11,None,8,None,8,None,11,None,None,None
1,None,None,None,None,None,7,5,None,11
19,9,None,11,None,None,None,1,None,1
1,None,None,1,None,hole,None,19,0,16
1,None,10,12,0,0,0,16,None,1
1,None,None,8,None,None,None,8,None,1
1,None,None,None,None,11,None,None,None,1
7,3,0,0,0,17,0,0,0,4